2,2,2,2,2,2,2,2,2,2,2
2,0,0,0,0,0,0,0,2,2,2
2,0,0,0,0,0,0,0,2,2,2
2,0,0,0,0,0,0,0,2,2,2
2,0,3,0,4,0,0,0,2,2,2
2,0,0,0,0,0,0,0,2,2,2
2,0,0,0,0,0,0,0,6,0,2
2,0,0,0,0,0,0,0,6,5,2
2,0,0,0,0,0,0,0,6,0,2
2,2,2,2,2,2,2,2,2,2,2