2,2,2,2,2,2,2,2,2
2,0,0,0,0,0,0,0,2
2,0,2,3,2,3,2,3,2
2,0,2,0,0,0,0,0,2
2,0,2,0,0,0,0,0,2
2,0,2,3,3,0,0,0,2
2,0,2,0,0,0,0,0,2
2,6,2,0,0,0,0,3,2
2,0,2,0,0,4,0,0,2
2,2,2,2,2,2,2,2,2