2,2,2,2,2,2,2,2,2
2,5,6,4,0,0,0,0,2
2,6,0,0,0,0,0,0,2
2,0,0,0,0,0,0,0,2
2,0,0,0,0,0,0,0,2
2,0,2,0,2,0,0,0,2
2,0,2,3,0,0,0,4,2
2,0,0,2,2,0,0,0,2
2,0,0,0,0,0,0,0,2
2,2,2,2,2,2,2,2,2