2,2,2,2,2,2,2,2,2,2,2
2,0,0,0,0,0,0,0,0,4,2
2,0,4,0,0,0,0,0,0,0,2
2,0,0,0,6,6,6,0,0,0,2
2,0,0,0,6,5,6,0,0,0,2
2,0,0,0,6,6,6,0,0,0,2
2,0,0,4,0,0,0,0,0,0,2
2,0,0,0,0,0,0,0,3,0,2
2,0,0,0,0,0,0,0,0,1,2
2,2,2,2,2,2,2,2,2,2,2