2,2,2,2,2,2,2,2,2
2,5,6,0,0,0,6,1,2
2,6,2,3,2,0,6,6,2
2,0,2,0,2,0,0,0,2
2,0,2,0,2,0,0,0,2
2,0,2,0,2,0,0,0,2
2,2,2,0,2,2,2,2,2
2,0,0,3,0,0,0,4,2
2,0,0,0,0,0,0,0,2
2,2,2,2,2,2,2,2,2