2,2,2,2,2,2,2,2,2
2,0,4,2,5,2,0,0,2
2,0,0,4,6,4,0,0,2
2,0,0,0,0,0,0,4,2
2,0,1,0,0,0,0,0,2
2,0,0,0,0,0,0,0,2
2,0,0,0,0,0,0,0,2
2,0,0,0,0,0,0,0,2
2,0,0,0,0,0,0,0,2
2,2,2,2,2,2,2,2,2