2,2,2,2,2,2,2,2,2
2,0,4,0,0,2,0,5,2
2,0,3,0,0,2,0,0,2
2,0,0,0,0,2,0,0,2
2,0,0,0,0,2,6,6,2
2,0,0,0,0,0,0,0,2
2,0,0,0,0,0,0,0,2
2,3,0,0,0,0,0,4,2
2,0,0,0,0,0,0,0,2
2,2,2,2,2,2,2,2,2